# A province can only belong to one area!

######################################
# Eastern Kingdoms
######################################
area_isle_of_quel_danas = {
	690 521 760 724 705 2990 2991 2992 2993 2994
}

area_eversong_woods = {
	558 978 676 660 704 944 626 609 643 1064 960 520 575 540 593 961 892 2985 2986 2987 2988 2989
}

area_ghostlands = {
	1029 1013 993 844 806 822 860 876 945 1012 1041 808 791 776 1039 1038 629 659 2977 2978 2979 2980 2981 2982 2983 2984
}

area_eastern_plaguelands = {
	592 625 608 642 723 1921 743 729 507 932 1922 915 1011 1028 519 574 1054 928 891 778 875 539 557 992 2970 2971 2972 2973 2974 2975 2976
}

area_western_plaguelands = {
	790 607 591 1923 703 722 688 821 843 859 805 742 775 2968 2969
}

area_tirisfal_glades = {
	964 979 1044 1015 560 931 740 1928 543 528 1927 1925 1926 646 662 727 2954 2955 2956 2957 2958 
}

area_silverpine_forest = {
	648 731 677 711 663 746 671 702 672 686 685 1924 720 2959 2960 2961 2962 2963 
}

area_hillsbrad_foothills = {
	756 943 773 556 538 518 1010 959 976 991 1027 741 721 845 863 2964 2965 2966 2967
}

area_gilneas = {
	914 505 525 848 757 809 789 774 962 927 908 890 820 842 858 804 
}

area_tol_barad = {
	2004 957 2003 2006 2005 2007 2009 2008 974 989 2011 2012 2010 2013
}

area_zul_dare = {
	691
}

area_kul_tiras = {
	570 2015 824 639 2014
}

area_arathi_highlands = {
	1931 1000 966 1929 527 981 1934 673 1932 687 506 897 1937 1935 1936 641 623 606 1933
}

area_the_hinterlands = {
	1930 889 644 926 763 942 975 958 990 1009 1026 1125 537 1938 517
}

area_wetlands = {
	874 788 1939 1940 999 516 536 554 571 1032 656 605 589 622 1055 580
}

area_twilight_highlands = {
	841 803 1061 1025 878 925 787 873 856 888 802 610 1016 755 739 701 632 614 581 542 613 730 631 561 710 744 597 2164
}

area_loch_modan = {
	1942 1941 1047 792 1046 1137 655 552 1945 1048 1944 
}

area_dun_morogh = {
	515 988 1943 1134 1007 973 956 941 855 817 1949 801 839 872 1140 887 1951 1142
}

area_badlands = {
	1967 1979 1974 1978 1969 1971 1972 1973 1976 1975 1970 1968 1977 
}

area_searing_gorge = {
	1953 1954 1955 1956 1957 1958 1965 1959 1960 1966 1961 1964 1962 
}

area_burning_steppes = {
	1952 1980 1981 1982 1983 1991 1984 1987 1986 1985 1990 1988 1989 
}

area_redridge_mountains = {
	1994 650 772 752 737 717 683 785 800 1992 816 838 669 1993 2190 2199 2197 2198 2196 2194 2195 2192 2163 2193
}

area_stormwind = {
	2149 2202 2205 2207 2141 2204 2142 2203 2206 2201 
	1022 
}

area_elwynn_forest = {
	661 954 1005 986 913 587 619 603 550 567 1058 533  2145 2146 2147 2148 2144 2143 2200 2140 2139 2138
}

area_swamp_of_sorrows = {
	885 638 547 949 707 994 725 864 594 879 1995 2185 2160 2184 2183 2159 2157 2186 2155 2180 2156 2187 2191 2179 2181 2188 2158 2189 
}

area_blasted_lands = {
	884 630 1050 807 1045 1033 1034 1043 1042 553 1035 1037 869 814 836 853 2176 2175 2172 2174 2173 2171 
}

area_deadwind_pass = {
	938 953 921 2182 2162 2161 
}

area_duskwood = {
	1021 1004 903 1057 985 970 586 698 653 682 637 618 602 2153 2152 2151 2150 2178 2177 2170
}

area_westfall = {
	622 904 627 837 870 751 736 716 771 596 815 612 799 1999 784 2000 922 2168 2169 2154 
}

area_stranglethorn_vale = {
	1996 1997 601 585 636 652 681 697 715 750 735 783 565 1056 548 531 511 1020 1003 984 969 920 937 902 852 868 883 996 693 997 1998 2165 2166 2167 
}

######################################
# Darnassus
######################################
area_teldrassil = {
	1070 1073 1069 1072 1068 1067 1071 1065 2096
}

######################################
# Exodar
######################################
area_bloodmyst_isle = {
	1085 1084 1075 1074 1076 1078 1077 1081 1083 1082 1080 1079 
}

area_azuremyst_isle = {
	1086 1088 1089 1095 1087 1093 1090 1091 1092 1094
}

######################################
# Kalimdor
######################################
area_moonglade = {
	1325 1326 1324 2135 2136
}

area_darkshore = {
	1296 1295 1297 1298 1299 1300 1301 1302 1303 1304 1305 1306 1307 
}

area_winterspring = {
	1323 1331 1329 1327 1328 1330 1332 1333 
}

area_felwood = {
	1322 1321 1320 1319 1318 1317 1316 1315 1314 
}

area_mount_hyjal = {
	1337 1335 1334 1336 1339 1338 1345 1347 1348 1340 1341 1342 1343 1344 1346 
}

area_ashenvale = {
	1308 1309 1312 1310 1311 1313 1349 1350 1351 1354 1352 1353 
}

area_azshara = {
	1434 1433 1435 1431 1432 1436 1430 1429 1428
}

area_durotar = {
	1377 1426 1379 1378 1381 1380 1372 1383 1382 1384 1385 
}

area_northern_barrens = {
	1370 1371 1420 1368 1421 1372 1373 1423 1375 1376 1422 1374 1443 1437
}

area_stonetalon_mountains = {
	1355 1359 1356 1358 1360 1386 1404 1407 1366 1369 1365 1408 1409 1367 1364 1363 1362 1405 1361 1357 1406 
}

area_desolace = {
	1400 1387 1388 1389 1401 1392 1393 1391 1390 1397 1402 1396 1394 1398 1395 1403 1399
}

area_mulgore = {
	1467 1468 1469 1470 1473 1482 1471 1484 1445 1472 1474 1483 1476 1475 1477 
}

area_southern_barrens = {
	1439 1440 1442 1441 1444 1446 1447 1464 1449 
}

area_dustwallow_marsh = {
	1448 1465 1451 1450 1461 1452 1463 1453 1455 1454 1462 1456 1438 
}

area_thousand_needles = {
	1457 1581 1460 1458 1459 1584 1583 1582 1580 1496 1550 1579 1585 
}

area_feralas = {
	1485 1497 1487 1486 1498 1488 1499 1490 1492 1491 1493 1495 1494 1489 
}

area_silithus = {
	1508 1509 1510 1511 1512 1513 1515 1514 1516 1519 1522 1517 1518 
}

area_un_goro_crater = {
	1526 1528 1529 1530 1539 1534 1527 1535 1540 1533 1531 1532 1537 1536 
}

area_tanaris = {
	1541 1543 1542 1554 1545 1553 1544 1552 1548 1555 1546 1538 1547 1549 1551 
}

area_uldum = {
	1556 1557 1558 1575 1562 1559 1576 1570 1571 1569 1577 1578 1572 1573 1568 1574 1564 1563 1565 1566 1567 1561 1560 
}

area_ahn_qiraj = {
	1521 1520
}

######################################
# Maelstrom
######################################
area_the_lost_isles = {
	1097 1098 1099 1100 1101 1109 1102 1104 1103 1105 1107 1106 
}

######################################
# Northrend
######################################
area_borean_tundra = {
	983 510 1052 1019 1002 919 968 936 951 1260 1258 1261 1233 1259 881 900 866 850 1281 530 2117 2118 2116 2122 2121 2123 2120 2119 2125
}

area_wintergrasp = {
	1282 708 834 862 2129 2126 2128 2127
}

area_dragonblight = {
	812 1283 955 796 781 748 545 733 529 982 509 768 1018 1051 713 563 634 599 583 679 935 995 2134 2131 2133 2132 2130
}

area_sholazar_basin = {
	559 766 578 826 595 939 1265 1264 971 762 877 692 916 526 1262 1263 2100 2098 2097 2115 2099
}

area_icecrown = {
	846 1225 761 1266 827 1226 1269 726 523 947 1267 1268 930 895 1270 911 829 777 628 576 830 998 901 
	
}

area_storm_peak = {
	522 645 1278 1277 896 1229 728 948 1227 1279 894 946 1280 541 764 828 1228 753 1286 1291 
}

area_zul_drak = {
	1284 649 664 615 598 633 544 779 582 562 1285 1017 898 933 917 810 832 794 1287 
}

area_grizzly_hills = {
	967 950 849 833 811 795 767 712 732 695 780 747 865 899 880 1289 918 834 2111 2112 2113 2114 934
}

area_crystalsong = {
	706 1271 893 1272 1273 1276 1274 825 1275 
}

area_howling_fjord = {
	1288 651 680 835 696 635 734 600 1290 584 564 546 882 769 749 782 714 867 851 2110 2102 2103 797 2104 2107 2106 2108 2105 2109 
}

######################################
# Outland 
######################################
area_hellfire_peninsula = {
	1586 2028 1587 1588 2029 1589 1590 1592 1594 2032 2031 2030 1593 2033 1591 2034 1596 1597 1599 1602 2035 1598 1595 
}

area_zangermarsh = {
	2049 1606 1605 1604 1603 1608 1607 1609 1610 2062 2063 1611 1617 2064 1612 1620 1614 1613 1615 1616 2065 2066 
}

area_terokkar_forest = {
	1652 1641 1642 2048 1643 1658 2043 2042 2041 1644 1654 1645 2038 2040 1651 2039 1646 1647 1655 2044 1648 2047 1656 1649 1657 2046 1650 2045
}

area_nagrand = {
	1647 1633 1634 2051 2052 1638 1631 2050 1632 1636 1628 1627 1629 1630 1635 1621 1626 1625 1623 1622 1624 1637 
}

area_shadowmoon_valley = {
	1661 1674 1662 1663 1676 1675 1668 1679 1669 1678 1664 1665 1666 2036 1672 1673 1677 2037 1670 1671 1667
}

area_blades_edge_mountains = {
	1619 1680 1681 1682 2053 1683 1684 1685 1686 1687 1688 1689 1690 2055 1692 1691 2054 1693 1694 1695 1696 1697 1699 1698 2101
}

area_netherstorm = {
	1704 1702 1701 2056 1703 1710 2057 1709 2058 1706 1707 1708 1717 1716 1715 2059 1705 1711 1712 1713 2060 1714 2061 
}

######################################
# Pandaria 
######################################
area_hidden_valley = {
	1800 1801 1802 1806
}

area_isle_of_thunder = {
	1884 1885 1886 1887 1883 1882 1888 1891 1889 1890
}

area_isle_of_giants = {
	1920
}

area_the_jade_forest = {
	1734 1735 1720 2068 1738 1718 2069 1739 2067 2070 2071 1721 1740 2072 1722 1723 1726 1727 1725 2076 2079 2073 1724 1733 2077 2080 2075 2074 1732 1729 1728 1730 1731 2078 1737 1719 1736
}

area_valley_of_the_four_winds = {
	1790 1786 1793 1804 1791 1792 1794 1796 1803 1795 1798 1797 1805 1799 1829
}

area_krasarang_wilds = {
	1785 1773 1788 1775 1774 1776 1784 1777 1778 1779 1780 1781 1782 1787 1783 1789 
}

area_dread_wastes = {
	1855 1838 1837 1844 1845 1836 1846 1834 1835 1847 1853 1848 1849 1851 1850 1833 1840 1852 1839 1854 1842 1841 1856 1857 1858 1832 1843
}

area_vale_of_eternal_blossoms = {
	1819 1823 1815 1817 1816 1814 1813 1821 1812 1824 1811 1818 1809 1810 1822 1820 1807 1808
}

area_townlong_steppes = {
	1859 1860 1874 1873 1872 1864 1875 1865 1866 1870 1876 1861 1862 1877 1863 1878 1871 1867 1880 1881 1879 1868 1869
}

area_kun_lai_summit = {
	1898 1911 1912 1908 1897 1910 1896 1895 1919 1894 1909 1907 1917 1918 1899 1914 1900 1906 1828 1893 1916 1915 1901 1913 1902 1904 1903 1892 1905
}